728
00000000000000000000000000000000000000000000000000000000000000000000000000000000000000000000000000000000555555555555555555555000000000000000000000000000000000000000000000000000000000000000000000000000000000000000000000000000000000000000000055555555555555555555555555555555550000000000000000000000000000000000000000000000000000000000000000000000000000000000000000000000000000000000000000000000000000000000000000000000000000000000000000000000000000000000000000000000000000000000000000000000000000000000000000000000000000000000000000000000000000000000000000000000000000000000000000000000000000000000000000000000000000000000000000000000000000000000000000000000000000000000000000000000000000000000000000000000000000000000000000000000
00000000000000000000000000000000000000000000000000000000000000000000000000000000000000000000000000000000555555555555555555550000000000000000000000000000000000000000000000000000000000000000000000000000000000000000000000000000000000000000000000555555555555000000000000055555000000000000000000000000000000000000000000000000000000000000000000000000000000000000000000000000000000000000000000000000000000000000000000000000000000000000000000000000000000000000000000000000000000000000000000000000000000000000000000000000000000000000000000000000000000000000000000000000000000000000000000000000000000000000000000000000000000000000000000000000000000000000000000000000000000000000000000000000000000000000000000000000000000000000000000000000
00000000000000000000000000000000000000000000000000000000000000000000000000000000000000000000000000000000555555555555555555000000000000000000000000000000000000000000000000000000000000000000000000000000000000000000000000000000000000000000000000555555500000000000000000005550000000000000000000000000000000000000000000000000000000000000000000000000000000000000000000000000000000000000000000000000000000000000000000000000000000000000000000000000000000000000000000000000000000000000000000000000000000000000000000000000000000000000000000000000000000000000000000000000000000000000000000000000000000000000000000000000000000000000000000000000000000000000000000000000000000000000000000000000000000000000000000000000000000000000000000000000
00000000000000000000000000000000000000000000000000000000000000000000000000000000000000000000000000000000555555555555555555000000000000000000000000000000000000000000000000000000000000000000000000000000000000000000000000000000000000000000000000055500000000000000000000000000000000000000000000000000000000000000000000055555555555555555555555555000000000000000000000000000000000000000000000000000000000000000000000000000000000000000000000000000000000000000000000000000000000000000000000000000000000000000000000000000000000000000000000000000000000000000000000000000000000000000000000000000000000000000000000000000000000000000000000000000000000000000000000000000000000000000000000000000000000000000000000000000000000000000000000000000
00000000000000000000000000000000000000000000000000000000000000000000000000000000000000000000000000000000555555555555555550000000000000000000000000000000000000000000000000000000000000000000000000000000000000000000000000000000000000000000000000005500000000000000000000000000000000000000000000000000000000000000000000005555555555555555555555555550000000000000000000000000000000000000000000000000000000000000000000000000000000000000000000000000000000000000000000000000000000000000000000000000000000000000000000000000000000000000000000000000000000000000000000000000000000000000000000000000000000000000000000000000000000000000000000000000000000000000000000000000000000000000000000000000000000000000000000000000000000000000000000000000
00000000000000000000000000000000000000000000000000000000000000000000000000000000000000000000000012222222555555555555555000000000000000000000000000000000000000000000000000000000000000000000000000000000000000000000000000000000000000000000000000005523000000000000000000000000000000000000000000000000000000000000000000000555555555555555555555555555000000000000000000000000000000000000000000000000000000000000000000000000000000000000000000000000000000000000000000000000000000000000000000000000000000000000000000000000000000000000000000000000000000000000000000000000000000000000000000000000000000000000000000000000000000000000000000000000000000000000000000000000000000000000000000000000000000000000000000000000000000000000000000000000
00000000000000000000000000000000000000000000000000000000000000000000000012222222222222222222222255555555555555555555550000000000000000000000000000000000000000000000000000000000000000000000000000000000000000000000000000000000000000000000000000005555230000012230000000000000000000000000000000000000000000000000000000000005555555555555555555555555555555500000000000000000000000000000000000000000000000000000000000000000000000000000000000000000000000000000000000000000000000000000000000000000000000000000000000000000000000000000000000000000000000000000000000000000000000000000000000000000000000000000000000000000000000000000000000000000000000000000000000000000000000000000000000000000000000000000000000000000000000000000000000000000
00000000000000000000000000000000000000000000000000000000000000000000000055555555555555555555555555555555555555555555000000000000000000000000000000000000000000000000000000000000000000000000000000000000000000000000000000000000000000000000000000000055552222255552223000000000000000000000000000000000000000000000000000000000005555555555555555555555555555555555555555500000000000000000000000000000000000000000000000000000000000000000000000000000000000000000000000000000000000000000000000000000000000000000000000000000000000000000000000000000000000000000000000000000000000000000000000000000000000000000000000000000000000000000000000000000000000000000000000000000000000000000000000000000000000000000000000000000000000000000000000000000
00000000000000000000000000000000000000000000000000000000000000000000000155555555555555555555555555555555555555555500000000000000000000000000000000000000000000000000000000000000000000000000000555555555555555000000000000000000000000000000000000000000000000000000000000000000000000000000000000000000000000000000000000000000000005555555555555555555555555555555555555550000000000000000000000000000000000000000000000000000000000000000000000000000000000000000000000000000000000000000000000000000000000000000000000000000000000000000000000000000000000000000000000000000000000000000000000000000000000000000000000000000000000000000000000000000000000000000000000000000000000000000000000000000000000000000000000000000000000000000000000000000
00000000000000000000000000000000000000000000000000000000000000000000000000000000000000000000000000000000005555500000000000000000000000000000000000000000000000000000000000000000000000000000000000055555555500000000000000000000000000000000000000000000000000000000000000000000122222300000000000000000000000000000000000000000000000000000005555555555555555555555555555555555555555555500000000000000000000000000000000000000000000000000000000000000000000000000000000000000000000000000000000000000000000000000000000000000000000000000000000000000000000000000000000000122230000000000000000000000000000000000000000000000000000000000000000000000000000000000000000000000000000000000000000000000000000000000000000000000000000000000000000000000
00000000000000000000000000000000000000000000000000000000000000000000000000000000000000000000000000000000000000000000000000000000000000000000000000000000000000000000000000000000000000000000000000000555555500000000000000000000000000000000000000000000000000000000000000012222555555522300000000000000000000000000000000000000000000000000000000555555555555555555555555555555555555555555555000000000000000000000000000000000000000000000000000000000000000000000000000000000000000000000000000000000000000000000000000000000000000000000000000000000000000000000000000122555552230000000000000000000000000000000000000000000000000000000012222220000000000000000000000000000000000000000000000000000000000000000000000000000000000000000000000000000
00000000000000000000000000000000000000000000000000000000000000000000000000000000000000000000000000000000000000000000000000000000000000000000000000000000000000000000000000000000000000000000000000000055555000000000000000000000000000000000000000000000000000000000000000000055555555555522300000000000000000000000000000000000000000000000000000500005555555555555555555555555555555555555555555000000000000000000000000000000000000000000000000000000000000000000000000000000000000000000000000000000000000000000000000000000000000000000000000000000000000000000000122555555555552300000000000000000000000000000000000000000000000000001255555552223000000000000000000000000000000000000000000000000000000000000000000000000000000000000000000000012
00000000000000000000000000000000000000000000000000000000000000000130000000000000000000000000000000000000000000000000000000000000000000000000000000000000012222223000000000000000000000000000000000000000555000000000000000000000000000000000000000000000000000000000000000000555555555000000000000040000000000000000000000000000000000000000000000000000000555555555555555555555555555555555555555500000000000000000000000000000000000000000000000000000000000000000000000000000000000000000000000000000000000000000000000000000000000000000000000000000000000000000012555555555555555500000000000000000000000000000000000000000000000000005555555555550000000000000000000000000000000000000000000000000000000000000000000000000000000000000000000122255
00000000000000000000000000000000000000000000000000000000000000001553000000000000000000000000000000000000000000000000000000000000000000000000000000000000000005550000000000000000000000000000000000000000550000000000000000000000000000000000000000000000000000000000000000000555550000000000000000050000000000000000000000000000000000000000000000000000000000055555555555555555555555555555555555500000000000000000000000000000000000000000000000000000000000000000000000000000000000000012222230000000000000000000000000000000000000000000000000000000000000000001255555555555555555500000000000000000000000000000000000000000000000000005555555500000000000000000000000000000000000000000000000000000000000000000000000000000000000000000000001555555
00000000000000000000000000000000000000000000000000012222222222225555222222300000000000000001222222223000000000000000000000000000000000000000000000000000000015550000000000000000000000000000000000000001550000000000000000000000000000000000000000000000000000000000000400005550000000000000000000050000004000000000000000000000000000000000000000000000000000000000000555555555555555555555555555500000000000000000000000000000000000000000000000000000000000000000000001222222222222222255555552222222222222230000000000000000000000000000000000000000000000000015555555555555555555500000000000000000000000000000001220000000000000000005555550000000000000000000000000000000000000000000000000000000000000000000000000000000000000000000000005555555
00000000000000000000000000000000000000000000000000155555555555555555555555522230000000001225555555555222222222222200000000000000000000000000122222300000000055550000000000000000000000000000000000000015550000000000000000000000000000000000000000000000000000000000000500005555000000000000000000050000005000000000012230000000000000000000000000000000000000000000000000000000000000000000000000000000000000000000000000000000000000012200000000000000000000000012222225555555555555555555555555555555555555552222223000000000000000000000000000000000000000122255555555555555555555500000000000000000012300000000005553000000000000000125550000000000000000000000000000000000000000000000000000000000000000000000000000000000000000000500000005555555
00000000000000000000000000000000000000000000012222555555555555555555555500000000000000015555555555555555555555555522222222230000000000122222555500000000000055550000000000000000000000000000000001222225550000000000000000000000000000122222300000000000000000000040000500005555000000000000000000050000005000004000005500000000000012222222000000000000000000000000000000000000000000000000000000000000000000000000000012222222222222255530000000000000000001222255555555555555555555555555555555555550000000000000000000000000000000000000000000012222300001555555555555555555555555500000122300000012255522223000015555300000000000122555500000000000000000000000000000000000000000000000000000000000000000005500000000000000000000000550000005555555
00000000000000000000000000000000000000000001255555555555555550000000000000000000000001255500000000000000000000000000000000000001222222555555555000004000000355500000000000000000000000000000000000000000000000000000000000000000000012555555522222222222222300000150000500005555000000000000000000050000005000005000005500000001222255555555000000000000000000000000000000000000000000000000000000000000000000001222222255555555555555555552230000000000000000000000000000000000000000000000000000000000000000000000000000000000000000000000000122255555522225555550000000000000055555522222555522222255555555555222255555522222222222555550000000000000000000000000000000000000000000000000000000000000000000000000000000000000000000000000000005555555
00000000000000000000000000000000000000000015555000000000000000000000000000000000001225000000000000000000000000000000000000000000555550000000000000005222222555500000000000000000000000000000000000000000000000000000000000000000012255555555555555555555555000000550000550005555500000000000000000050000005000005000005500000000005555555555000000000000000000000000000000000000000000000000000000000000000000015555550000000000005555555555552222222300000000000000000000000000000000000000000000000000000000000000000000000000000000000122222555500000000000000000000000000000000000555555555555555500000000000000000000000000000000000000000000000000000000000000000000000000000000000000000000000000000000000000000000000000000000000000000005555555
00000000000000000000000000000000000000000155500000000000000000000000000000000000000000000000000000000000000000000000000000000000000000000000000000000555555550000000000000000000000000000000000000000000000000000000000000122222255555555555555555555555555000000550000550005555500000000000000000050000005000005000005500000000000005555555000000000000000000000000000000000000000000000000000000000000000000055000000000000000000055555555555555555523000000000000000000000000000000000000000000000000000000000000000000000000000001222555500000000000000000000000000000000000000000000000000000000000000000000000000000000000000000000000000005555500000000000000000000000000000000000000000000000000000000000000000000000000000000000000000055555555
00000000000000000000000000000000000000001555500000000000000000000000000000000500000000000000000000000000000000000000000000000000000000000000000000000555555000000000000000000000000000000000000000000000000000000000000000555555555555555555555555555555550000000550000550005555500000000000000000055000005000005000005500000000000000555550000000000000000000000000000000000000000000000000000000000000000000150000000000000000000000555555555555555555000000000000000000000000000000000000000000000000000000000000000000000000000000000000000000000000000000000000000000000000000000000000000000000000000000000000000000000000000000000000000055500000000000000000000000000000000000000000000000000000000000000000000000000000000000000000000055555555
00000000000000000000000000000000000000015555500000000000000000000000000000000500000000000000000000000000000000000000000000000000000000000000000000000055555000000000000000000000000000000000000000000000000000000000000001555555555555555555555555555555500000000555000550005555550000000000000000055000005000005000005500000000000000555550000000000000000000000000000000000000000000000000000000000000000000000000000000000000000000005555555555555555300000000000000000000000000000000000000000000000000000000000000000000000000000000000000000000000000000000000000000000000000000000000000000000000000000000000000000000000000000000000005555000000000000000000000000000000000000001222222222230000000050000000000000000000000000000000000055555555
00000000000013000000000000000000000000155555500000000000000000000000000000000500000000000000000000000000000000500000000000005000000000000000000000000055550000000000000000000000000000000000000000000000000000000000012225555555555555555555555555555555500000005555000550005555555000000000000000055500005500005000005500000000000000555555555555000000000000000055000000000000000000000000000000000000000000000000000000000000000000000555555555555555530000000000000000000000000000000000000000000000000000000000000000000000000000000000000000000000000000000000000000000000000000000000000000000000005555000000000000000000000000555555555550000000000000000000000000000000000122225555555555552222222250000000000000000000000000000000000055555555
00000000001255300000000000000000000001555555555555000000000000000000000000055500000000000000000000000000005555500000555555555500000000000000000000000055550000000000000000000000000000000000000000000000000000000122255555555555555555555555555555555555500000005555000550005555555550000000000000055500005500005000005500000000000000055555555555555555000000005555555500000000000055550000000000000000000000000000000000000000000000000055555555555555552225500000000000000000000000000005555550000000000000000000000000000012223000000000000000000000000000000000000005555550000000000000000000000005555555550000000000000000055555555555555500000000000000000000000000000000000555555555555555555555555550000000000000000000000000000000000055555555
00000000125555530000000000000000001225555555555555555555555555555000000005555555555555500000000000000055555555555555555555555500000000000000000000000005550000000000000001222222222222300000122222223000000000012555555555555555555555555555555555555555500000005555555550005555555555000000000000055500005500055000055500000000005555555555555555555555555555555555555555555555555555555555555555500000000000000050000000000000000000000055555555555555555555555550000000000005555555555555555555555555555555500000000001222255555225550000000000000005555555555500000055555555555500000000000000005555555555555555555555555555555555555555555500000000000122222300000000000001222555555555555555555555555555555555555555555555555555555555555555555555
12222222555555552222222222222222225555555555555555555555555555555555500055555555555555555555000555555555555555555555555555555550000000000000000000000005500000000000000000000055555555522222555555555222222222255555555555555555555555555555555555555555500000005555555550005555555555550000000000055500005500055000055500000000055555555555555555555555555555555555555555555555555555555555555555555555555555555555555555555555555555555555555555555555555555555555555555555555555555555555555555555555555555555555555225555555555555555555555555555555555555555555555555555555555555555555555555555555555555555555555555555555555555555555555555555555555555555522222222222225555555555555555555555555555555555555555555555555555555555555555555555555
00000000000000000000000000000000000000000000000000000000000000000000000000000000000000000000000000000000000000000000000000000000000000000000000000000000000000000000000000000000000000000000000000000000000000000000000000000000000000000000000000000000000000000000000000000000000000000000000000000000000000000000000000000000000000000000000000000000000000000000000000000000000000000000000000000000000000000000000000000000000000000000000000000000000000000000000000000000000000000000000000000000000000000000000000000000000000000000000000000000000000000000000000000000000000000000000000000000000000000000000000000000000000000000000000000000000000000000000000000000000000000000000000000000000000000000000000000000000000000000000000000000
00000000000000000000000000000000000000000000000000000000000000000000000000000000000000000000000000000000000000000000000000000000000000000000000000000000000000000000000000000000000000000000000000000000000000000000000000000000000000000000000000000000000000000000000000000000000000000000000000000000000000000000000000000000000000000000000000000000000000000000000000000000000000000000000000000000000000000000000000000000000000000000000000000000000000000000000000000000000000000000000000000000000000000000000000000000000000000000000000000000000000000000000000000000000000000000000000000000000000000000000000000000000000000000000000000000000000000000000000000000000000000000000000000000000000000000000000000000000000000000000000000000